{
	"currentWave":-1,
	"tileId":[0,         0,         0,         0,         0,         0,       113,         0,         0,         0,         0,         0,         0,         0,         0,         0,
		  0,         0,         0,         0,         0,    200110,       113,         0,         0,         0,         0,         0,         0,         0,         0,         0,
   		  0,         0,       123,       124,       124,       124,       114,         0,         0,         0,         0,         0,         0,         0,         0,         0,  
 		  0,         0,       113,         0,         0,         0,         0,         0,         0,         0,         0,         0,         0,         0,         0,         0,   
		  0,         0,       113,        201111,     0,    201010,         0,    201001,         0,         0,         0,         0,         0,         0,         0,         0,
   		  0,         0,       112,       142,       142,       142,       142,       142,      1243,       124,       124,       124,       124,       134,         0,         0,
   		  0,         0,         0,         0,         0,         0,         0,         0,       113,         0,         0,         0,         0,       131,         0,         0,
 		124,       124,       124,       124,       124,       124,       124,       124,       114,         0,         0,         0,         0,       121,       124,       124,
   		  0,         0,         0,         0,         0,         0,         0,         0,         0,         0,         0,         0,         0,         0,         0,         0],
	"waveDelay":[10,10],
	"waveInfo":["1x10.2x5.1x10.","2x10.1x5."],
	"wavesAmmount":2,
	"wavePosition":[6, 127],
}
